16,16,16,16,16,16,16,16,16,16
16,16,16,16,16,16,6,14,12,16
16,6,12,16,16,16,3,11,9,16
16,3,9,16,16,16,16,16,16,16
16,16,16,16,16,16,16,16,16,16
16,16,16,16,16,16,16,16,16,16
16,6,12,16,16,6,14,12,16,16
16,7,13,16,16,7,15,13,16,16
16,7,13,16,16,3,11,9,16,16
16,7,13,16,16,16,16,16,16,16


0,0,0,0,0,0,0,0,0,0
0,0,0,3,3,3,9,0,0,0
0,0,3,3,3,9,3,3,0,0
3,3,3,0,7,9,0,3,0,0
3,0,7,7,7,9,7,0,9,0
3,0,7,3,0,9,7,9,3,0
3,7,9,9,9,9,9,9,0,0
0,7,0,0,0,9,3,0,7,7
0,3,3,3,3,3,0,3,0,7
0,0,0,0,0,0,0,0,0,0
